0 0 0 0 0 0 0 0 0 0 0 0 0 0 0 0 0 0 0 0 0 0 0 0 0 0 0 0 0 0 0 0 0 0 0 0 0 0 0 0 0 0 0 0 0 0 0 0 0 0 
0 0 0 0 0 0 0 0 0 0 0 0 0 0 0 0 0 0 0 0 0 0 0 0 0 0 0 0 0 0 0 0 0 0 0 0 0 0 0 0 0 0 0 0 0 0 0 0 0 0 
0 0 0 0 0 0 0 0 0 0 0 0 0 0 0 0 0 0 0 0 0 0 0 0 0 0 0 0 0 0 0 0 0 0 0 0 0 0 0 0 0 0 0 0 0 0 0 0 0 0 
0 0 0 0 0 0 0 0 0 0 0 0 0 0 0 0 0 0 0 0 0 0 0 0 0 0 5 12 12 12 12 12 12 1 0 0 0 0 0 0 0 0 0 0 0 0 0 0 0 0 
0 0 0 0 0 0 0 0 0 0 0 0 0 0 0 0 5 12 12 12 12 12 12 12 12 1 14 19 19 19 19 19 19 20 0 0 0 0 0 0 0 0 0 0 0 0 0 0 0 0 
0 0 0 0 0 0 0 0 0 0 0 0 0 0 0 0 14 19 19 19 19 19 19 19 19 20 14 19 19 19 19 19 19 20 5 15 15 15 15 15 20 0 0 0 0 0 0 0 0 0 
0 0 0 0 0 0 0 0 0 0 0 0 0 0 0 0 14 19 19 19 19 19 19 19 19 20 14 19 19 9 8 19 19 20 14 13 13 13 13 13 20 0 0 0 0 0 0 0 0 0 
0 0 0 0 0 0 0 0 0 0 0 0 0 0 0 0 14 19 19 19 19 19 19 19 19 20 14 19 19 20 14 19 19 18 4 13 13 13 13 13 20 0 0 0 0 0 0 0 0 0 
0 0 0 0 0 0 0 0 0 0 0 0 0 0 0 0 14 19 19 19 19 19 19 19 19 20 14 19 19 20 14 19 19 13 13 13 13 13 13 13 20 0 0 0 0 0 0 0 0 0 
0 0 0 0 0 0 0 0 0 0 0 0 0 0 0 0 14 19 19 19 19 19 19 19 19 20 14 19 19 17 3 19 19 9 7 8 13 13 13 13 20 0 0 0 0 0 0 0 0 0 
0 0 0 0 0 0 0 0 0 5 3 19 17 1 0 0 14 19 19 19 19 19 19 19 19 20 14 19 19 19 19 19 19 20 5 4 13 13 13 13 20 0 0 0 0 0 0 0 0 0 
0 0 0 0 0 0 0 0 0 14 19 19 19 20 0 0 14 19 19 19 19 19 19 19 19 20 14 19 19 19 19 19 19 20 14 13 13 13 13 13 20 0 0 0 0 0 0 0 0 0 
0 0 0 0 0 0 0 0 0 14 19 19 19 20 0 0 21 7 7 8 19 9 7 7 7 6 14 19 19 19 19 19 19 20 14 13 13 13 13 13 20 0 0 0 0 0 0 0 0 0 
0 0 0 0 0 0 0 0 0 14 19 19 19 17 12 12 12 12 12 3 19 17 12 12 12 12 3 19 19 19 19 19 19 20 21 7 7 7 7 7 6 0 0 0 0 0 0 0 0 0 
0 0 0 0 0 0 0 0 0 14 19 19 19 19 19 19 19 19 19 19 19 19 19 19 19 19 19 19 19 9 8 19 19 20 5 15 15 15 15 15 1 0 0 0 0 0 0 0 0 0 
0 0 0 0 0 0 0 0 0 14 19 19 19 19 19 19 19 19 19 19 19 19 19 19 19 19 19 19 19 20 14 19 19 20 14 13 13 13 13 13 20 0 0 0 0 0 0 0 0 0 
0 0 0 0 0 0 0 0 0 14 19 19 19 19 19 19 19 19 19 19 19 19 19 19 19 19 19 19 19 20 14 19 19 20 14 13 13 13 13 13 20 0 0 0 0 0 0 0 0 0 
0 0 0 0 0 0 0 0 0 21 7 7 7 7 7 7 7 7 8 19 19 19 19 19 19 19 19 19 19 17 3 19 19 17 3 13 13 13 13 13 20 0 0 0 0 0 0 0 0 0 
0 0 0 0 0 0 0 0 0 0 0 0 0 0 0 0 0 0 14 19 19 19 19 19 19 19 19 19 19 19 19 19 19 13 13 13 13 13 13 13 20 0 0 0 0 0 0 0 0 0 
0 0 0 0 0 0 0 0 0 0 0 0 0 0 0 0 0 0 14 19 19 19 19 19 19 19 19 19 19 19 19 19 19 9 8 13 13 13 13 13 20 0 0 0 0 0 0 0 0 0 
0 0 0 0 0 0 0 0 0 0 0 0 0 0 0 0 0 0 21 7 7 7 8 19 19 9 7 7 7 7 8 19 19 20 21 7 7 7 7 7 6 0 0 0 0 0 0 0 0 0 
0 0 0 0 0 0 0 0 5 10 10 10 10 10 10 10 10 10 10 10 10 10 16 19 19 20 0 0 0 0 14 19 19 20 5 15 15 15 15 15 1 0 0 0 0 0 0 0 0 0 
0 0 0 0 0 0 0 0 14 2 2 2 2 2 2 2 2 2 2 2 2 2 2 19 19 20 0 0 0 0 14 19 19 20 14 13 13 13 13 13 20 0 0 0 0 0 0 0 0 0 
0 0 0 0 0 0 0 0 14 2 2 2 2 2 2 2 2 2 2 9 7 7 8 19 19 17 12 12 12 12 3 19 19 20 14 13 13 13 13 13 20 0 0 0 0 0 0 0 0 0 
0 0 0 0 0 0 0 0 14 2 2 2 2 2 2 2 2 2 2 20 0 0 14 19 19 19 19 19 19 19 19 19 19 18 4 13 13 13 13 13 20 0 0 0 0 0 0 0 0 0 
0 0 0 0 0 0 0 0 14 2 2 2 2 2 2 2 2 2 2 20 0 0 14 19 19 19 19 19 19 19 19 19 19 13 13 13 13 13 13 13 20 0 0 0 0 0 0 0 0 0 
0 0 0 0 0 0 0 0 14 2 2 2 2 2 2 2 2 2 2 20 0 0 14 19 19 19 19 19 19 19 19 19 19 9 8 13 13 13 13 13 20 0 0 0 0 0 0 0 0 0 
0 0 0 0 0 0 0 0 14 2 2 2 2 2 2 9 8 19 19 20 0 0 14 19 19 19 19 19 19 19 19 19 19 20 14 13 13 13 13 13 20 0 0 0 0 0 0 0 0 0 
0 0 0 0 0 0 0 0 14 2 2 2 2 2 2 20 14 19 19 20 0 0 14 19 19 19 19 19 19 19 19 19 19 20 21 7 7 7 7 7 6 0 0 0 0 0 0 0 0 0 
0 0 0 0 0 0 0 0 14 2 2 2 2 2 2 20 14 19 19 20 0 0 21 7 7 7 8 19 19 9 7 7 7 6 0 0 0 0 0 0 0 0 0 0 0 0 0 0 0 0 
0 0 0 0 0 0 0 0 14 2 2 2 2 2 2 20 14 19 19 17 12 12 20 0 0 0 14 19 19 20 0 0 0 0 0 0 0 0 5 10 10 10 10 10 1 0 0 0 0 0 
0 0 0 0 0 0 0 0 21 7 7 7 7 7 7 6 14 19 19 19 19 19 20 0 0 0 14 19 19 20 0 0 0 0 0 0 0 0 14 2 2 2 2 2 20 0 0 0 0 0 
0 0 0 0 0 0 0 0 0 0 0 0 0 0 0 0 14 19 19 19 19 19 20 0 0 0 14 19 19 20 0 0 0 0 0 0 0 0 14 2 2 2 2 2 20 0 0 0 0 0 
0 0 0 0 5 12 12 12 12 12 12 12 12 12 12 12 12 12 12 3 19 19 17 12 12 12 3 19 19 20 0 5 10 10 10 10 10 10 16 2 2 2 2 2 20 0 0 0 0 0 
0 0 0 0 14 19 19 19 19 19 19 19 19 19 19 19 19 19 19 19 19 19 19 19 19 19 19 19 19 20 0 14 2 2 2 2 2 2 2 2 2 2 2 2 20 0 0 0 0 0 
0 0 0 0 14 19 19 19 19 19 19 19 19 19 19 19 19 19 19 19 19 19 19 19 19 19 19 19 19 20 0 14 2 2 2 2 2 2 2 2 2 2 2 2 20 0 0 0 0 0 
0 0 0 0 14 19 19 9 7 7 7 7 7 7 7 7 7 7 7 8 19 19 9 7 7 7 8 19 19 20 0 14 2 2 2 2 2 2 2 2 2 2 2 2 20 0 0 0 0 0 
0 0 0 0 14 19 19 18 15 15 15 15 1 5 15 15 15 15 15 4 19 19 18 1 0 0 14 19 19 20 0 14 2 2 2 2 2 2 2 2 2 2 2 2 20 0 0 0 0 0 
0 0 0 0 14 19 19 13 13 13 13 13 20 14 13 13 13 13 13 13 13 13 13 20 0 0 14 19 19 20 0 14 2 2 2 2 2 2 2 2 2 2 2 2 20 0 0 0 0 0 
0 0 0 0 14 19 19 9 8 13 13 13 20 14 13 13 13 13 13 13 13 13 13 20 0 0 14 19 19 20 0 21 7 7 7 7 7 8 19 19 9 7 7 7 6 0 0 0 0 0 
0 0 0 0 14 19 19 20 14 13 13 13 20 14 13 13 13 13 13 13 13 13 13 20 0 0 14 19 19 20 0 0 0 0 0 0 0 14 19 19 20 0 0 0 0 0 0 0 0 0 
0 0 0 0 14 19 19 20 14 13 13 13 20 14 13 13 13 13 13 13 13 13 13 20 0 0 14 19 19 17 12 12 12 12 12 12 12 3 19 19 17 12 12 12 12 1 0 0 0 0 
0 0 0 0 14 19 19 20 14 13 13 13 20 14 13 13 13 13 13 13 13 13 13 20 0 0 14 19 19 19 19 19 19 19 19 19 19 19 19 19 19 19 19 19 19 20 0 0 0 0 
0 0 0 0 14 19 19 20 14 13 13 13 20 21 7 7 7 7 7 7 7 7 7 6 0 0 14 19 19 19 19 19 19 19 19 19 19 19 19 19 19 19 19 19 19 20 0 0 0 0 
0 0 0 0 21 7 7 6 21 7 7 7 6 0 0 0 0 0 0 0 0 0 0 0 0 0 21 7 7 7 7 7 7 7 7 7 7 7 7 7 7 7 7 7 7 6 0 0 0 0 
0 0 0 0 0 0 0 0 0 0 0 0 0 0 0 0 0 0 0 0 0 0 0 0 0 0 0 0 0 0 0 0 0 0 0 0 0 0 0 0 0 0 0 0 0 0 0 0 0 0 
0 0 0 0 0 0 0 0 0 0 0 0 0 0 0 0 0 0 0 0 0 0 0 0 0 0 0 0 0 0 0 0 0 0 0 0 0 0 0 0 0 0 0 0 0 0 0 0 0 0 
0 0 0 0 0 0 0 0 0 0 0 0 0 0 0 0 0 0 0 0 0 0 0 0 0 0 0 0 0 0 0 0 0 0 0 0 0 0 0 0 0 0 0 0 0 0 0 0 0 0 
0 0 0 0 0 0 0 0 0 0 0 0 0 0 0 0 0 0 0 0 0 0 0 0 0 0 0 0 0 0 0 0 0 0 0 0 0 0 0 0 0 0 0 0 0 0 0 0 0 0 
0 0 0 0 0 0 0 0 0 0 0 0 0 0 0 0 0 0 0 0 0 0 0 0 0 0 0 0 0 0 0 0 0 0 0 0 0 0 0 0 0 0 0 0 0 0 0 0 0 0 
