0 0 0 0 0 0 0 0 0 0 0 0 0 0 0 0 0 0 0 0 0 0 0 0 0 0 0 0 0 0 0 0 0 0 0 0 0 0 0 0
0 0 0 0 0 0 0 0 0 0 0 0 0 0 0 0 0 0 0 0 0 0 0 0 0 0 0 0 0 0 0 0 0 0 0 0 0 0 0 0
0 0 0 0 0 0 0 0 0 0 0 0 0 0 0 0 0 0 0 0 0 0 0 0 0 0 0 0 0 0 0 0 0 0 0 0 0 0 0 0
0 0 0 0 0 0 0 0 0 0 0 0 0 0 0 0 0 0 0 0 0 0 0 0 0 0 0 0 0 0 0 0 0 0 0 0 0 0 0 0
0 0 0 0 0 0 0 0 0 0 0 0 0 0 0 0 0 0 0 0 0 0 0 0 0 0 0 0 0 0 0 0 0 0 0 0 0 0 0 0
0 0 0 0 0 0 0 0 0 0 0 0 7 21 21 21 21 21 21 21 21 21 21 21 21 21 21 21 21 8 0 0 0 0 0 0 0 0 0 0
0 0 0 0 0 0 0 0 0 0 0 0 7 19 19 19 19 19 19 19 19 19 19 19 19 19 19 19 19 8 0 0 0 0 0 0 0 0 0 0
0 0 0 0 0 0 0 0 0 0 0 0 7 19 19 19 19 19 19 19 19 19 19 19 19 19 19 19 19 8 0 0 0 0 0 0 0 0 0 0
0 0 0 0 0 0 0 0 0 0 0 0 7 19 19 19 19 19 19 19 19 19 19 19 19 19 19 19 19 8 0 0 0 0 0 0 0 0 0 0
0 0 0 0 0 0 0 0 0 0 0 0 7 19 19 19 19 19 19 19 19 19 19 19 19 6 5 19 19 8 0 0 0 0 0 0 0 0 0 0
0 0 0 0 0 0 0 0 0 0 0 0 7 19 19 19 19 19 19 19 19 19 19 19 19 20 22 19 19 8 0 0 0 0 0 0 0 0 0 0
0 0 0 0 0 0 0 0 0 0 0 0 7 19 19 19 19 19 19 19 19 19 19 19 19 19 19 19 19 8 7 13 13 13 13 13 13 13 13 8
0 0 0 0 0 0 0 0 0 0 0 0 7 19 19 19 19 19 19 19 19 19 19 19 19 19 19 19 19 8 7 15 15 15 15 15 15 15 15 8
0 0 0 0 0 0 0 0 0 0 0 0 7 19 19 19 19 19 19 19 19 19 19 19 19 19 19 19 19 8 7 15 15 15 15 15 15 15 15 8
0 0 0 0 0 0 0 0 0 0 0 0 7 19 19 19 19 19 19 19 19 19 19 19 19 19 19 19 19 8 7 15 15 15 15 15 15 15 15 8
0 0 0 0 0 0 0 0 0 0 0 0 2 2 2 2 2 2 4 1 1 3 2 2 2 6 5 1 1 8 7 15 15 15 15 15 15 15 15 8
0 0 0 0 0 0 0 0 0 0 0 0 1 1 1 1 1 1 1 1 1 1 1 1 1 8 7 1 1 12 13 15 15 15 15 15 15 15 15 8
0 0 0 0 0 0 0 0 0 0 0 0 1 1 1 1 1 1 1 1 1 1 1 1 1 3 2 1 1 15 15 15 15 15 15 15 15 15 15 8
0 0 0 0 0 0 0 0 0 0 0 0 1 1 1 1 1 1 1 1 1 1 1 1 1 1 1 1 1 6 5 15 15 15 15 15 15 15 15 8
0 0 0 0 0 0 0 0 0 0 0 0 1 1 1 1 1 1 1 1 1 1 1 1 1 1 1 1 1 8 7 15 15 15 15 15 15 15 15 8
0 0 0 0 0 0 0 0 0 0 0 0 1 1 1 1 1 1 1 1 1 1 1 1 1 1 1 1 1 8 11 9 9 9 9 9 9 9 9 10
0 0 0 0 0 0 0 0 0 0 0 0 9 9 9 9 9 9 5 1 1 6 9 9 9 9 5 1 1 8 7 13 13 13 13 13 13 13 13 8
0 0 0 0 0 0 0 0 0 0 0 0 0 0 0 0 0 0 0 0 0 0 0 0 0 0 7 1 1 8 7 15 15 15 15 15 15 15 15 8
0 0 0 0 0 0 0 0 0 0 0 0 0 0 0 0 0 0 0 0 0 0 0 0 0 0 7 1 1 12 13 15 15 15 15 15 15 15 15 8
0 0 0 0 0 0 0 0 0 0 0 0 0 0 0 0 0 0 0 0 0 0 0 0 0 0 7 1 1 15 15 15 15 15 15 15 15 15 15 8
0 0 0 0 0 0 0 0 0 0 0 0 0 0 0 0 0 0 0 0 0 0 0 0 0 0 7 1 1 6 5 15 15 15 15 15 15 15 15 8
0 0 0 0 0 0 0 0 0 0 0 0 0 0 0 0 0 0 0 0 0 0 0 0 0 0 7 1 1 8 7 15 15 15 15 15 15 15 15 8
0 0 0 0 0 0 0 0 0 0 0 0 0 0 0 0 0 0 0 0 0 0 0 0 0 0 7 1 1 8 7 15 15 15 15 15 15 15 15 8
0 0 0 0 0 0 0 0 0 0 0 0 0 0 0 0 0 0 0 0 0 0 0 0 0 0 7 1 1 8 7 15 15 15 15 15 15 15 15 8
0 0 0 0 0 0 0 0 0 0 0 0 0 0 0 0 0 0 0 0 0 0 0 0 0 0 7 1 1 8 11 9 9 9 9 9 9 9 9 10
0 0 0 0 0 0 0 0 0 0 0 0 0 0 0 0 0 0 0 0 0 0 0 0 0 0 4 1 1 3 2 2 2 2 2 2 2 2 2 8
0 0 0 0 0 0 0 0 0 0 0 0 0 0 0 0 0 0 0 0 0 0 0 0 0 0 1 1 1 1 1 1 1 1 1 1 1 1 1 8
0 0 0 0 0 0 0 0 0 0 0 0 0 0 0 0 0 0 0 0 0 0 0 0 0 0 1 1 1 1 1 1 1 1 1 1 1 1 1 8
0 0 0 0 0 0 0 0 0 0 0 0 0 0 0 0 0 0 0 0 0 0 0 0 0 0 9 9 9 9 9 9 9 9 9 9 9 9 9 10
0 0 0 0 0 0 0 0 0 0 0 0 0 0 0 0 0 0 0 0 0 0 0 0 0 0 0 0 0 0 0 0 0 0 0 0 0 0 0 0
0 0 0 0 0 0 0 0 0 0 0 0 0 0 0 0 0 0 0 0 0 0 0 0 0 0 0 0 0 0 0 0 0 0 0 0 0 0 0 0